111111111111111111        
100000000010000101
1000W000000001000111
 1000001110000000011
10000000011100000111111
10000000110001000000111111
1111010101110010000000001
    100000001010100011111
1111000001000000000111
11000001000001111111
11110000000000000101
111111111111010101111
11111100000000011
10000000111111111
111111111

NO ./map/texture/Brick.xpm42
EA ./map/texture/Green.xpm42
WE ./map/texture/Cracked.xpm42
SO ./map/texture/Wooden.xpm42

F 200,200,200
C 255,00,0