NO ./map/texture/Brick.xpm42
EA ./map/texture/Green.xpm42
WE ./map/texture/Cracked.xpm42
SO ./map/texture/Wooden.xpm42
F 200,200,200
C 255,00,0

11111111111          1111111111
10000000001111111111100000000001
1000000000000000000000000000000111111
1100W00011111111111110000000000000001
1111111000001100000100000000000111111
  101111100000001011111000010001
  1001111000010000111111100000011111
111000100000001111      1111000000011         
1111111000101111            1000000001   111111
1100000000101                111100000111100001
 100000100101                    11000000000001
 100100100001                      111111111101
 11000000011111111111111111111111111111111111111
   10000000000000000000000000000000000000111111
    11111111111111111111111110000000001000000001
                            10000000000011000001
                            10110001000011000001
                            10010000000000000001
                            10000100000100000000
                            10000000000000000001
                            11111111111111111111
