NO ./map/texture/Brick.xpm42
EA ./map/texture/Green.xpm42
WE ./map/texture/Cracked.xpm42
SO ./map/texture/Wooden.xpm42
F 50, 0, 0
C 48, 213, 200

        1111111111111111111111111
        1000000000110000000000001
        1011000000000000000000001
        1111110111111011111111111
111111111011000001110000010000001
100000000011000001111101111111111
11110111111111011100000010001
11110111111111011101010010001
11000000110101011100000010001
10000000000000001100001110001
10000000000000001101000000001
11000001110101011111011110N0111
11110111 1110101 101111010001
11111111 1111111 111111111111